#

 Nice, you made it! Here, take this flag:
   ____ ____  ____      __     ____                      _ ____  _       _  _        _____ _     ____      _  _  ____ _____ _ _______   
  / ___/ ___||  _ \    / /   _|___ \ _ ____      ___ __ / | ___|/ |_ __ | || |  _ __|___  | |__ |___ \ ___| || || ___|___  / |___ /\ \  
 | |   \___ \| |_) |  | | | | | __) | '_ \ \ /\ / / '_ \| |___ \| | '_ \| || |_| '_ \  / /| '_ \  __) / __| || ||___ \  / /| | |_ \ | | 
 | |___ ___) |  _ /   | | |_| |/ __/| |_) \ V  V /| | | | |___) | | | | |__   _| | | |/ / | | | |/ __/ (__|__   _|__) |/ / | |___) | | |
  \____|____/|_| \_\  | |\__,_|_____| .__/ \_/\_/ |_| |_|_|____/|_|_| |_|  |_| |_| |_/_/  |_| |_|_____\___|  |_||____//_/  |_|____/ | | 
                       \_\          |_|                                                                                            /_/  
  
 Hope you had fun, I sure did ;)
 